11111111111
1P000000001
10110011101
1001C100101
10001100001
10001110001
10001100001
1C110C00101
11110001101
1C000E11C01
11111111111