11111111111111111
100000V0000C00001
100C0000P00000001
11011100001111001
1E0111000011C0001
1000000C0011110C1
11111111111111111